1111111111111
1P0100C000001
1000011111001
10C011E00C001
1111111111111